11111111111
1EC00G00101
1000100K001
10P01111001
11111111111
