11111111111
1EC000001E1
10001P00001
100011110C1
11111111111
