1111111111111111111
10000C00000000000E1
1000000100000000C01
1P00000111110000001
1111111111111111111
