11111111111
1EC00000101
10001000001
10P01111001
11111111111
