1111111111111111111
100E0000000000000E1
1000000100000000001
10P000111110C00P001
1111111111111111111
