1111111111111111111
10000C0000000000001
1000000000000000001
1000000000000000001
1000000100000000001
1000000100000000C01
1P00000111110000001
1000000000000000001
1000000000000000001
10000C0000000000001
10000000000000C0001
10000000000000000E1
1111111111111111111
