1111111111111111111
100000011C000000C01
1P00000111111000001
10000000000000000E1
1111111111111111111
