1111111111111111111
10000001100000000C1
1P00000111111000001
10000000000000000E1
1111111111111111111
