11111111111111111
100E00000000000C1
1P000001111000001
10000G0G000000001
11111111111111111
